6 5 7 5 5 5 5 5 7 5 5 5 5 5 7 5 5 5 5 5 7 5 5 5 5 5 7 5 5 5 5 5 7 5 5 5 5 5 5 5 5 5 5 5 5 5 5 5 7 5
4 1 8 1 1 3 1 1 8 1 1 1 1 1 8 1 1 1 1 1 8 1 1 1 1 1 8 1 1 1 1 1 8 1 1 1 1 1 1 1 1 1 3 1 1 1 1 1 8 1
4 1 8 1 1 1 1 1 8 1 1 1 1 1 8 1 1 1 1 1 8 1 1 1 3 1 8 1 1 1 1 1 8 1 1 1 1 1 1 1 1 1 1 1 1 1 1 1 8 1
4 0 9 0 0 0 0 0 9 0 0 0 0 0 9 0 0 0 0 0 9 0 0 0 0 0 9 0 0 0 0 0 9 0 0 0 0 0 0 0 0 0 0 0 0 0 0 0 9 0
4 0 0 0 0 2 0 0 0 0 0 10 0 0 0 0 0 2 0 0 0 0 0 0 10 0 0 0 0 10 0 0 0 2 0 0 0 0 0 2 0 0 0 2 0 0 2 0 2 0
4 2 0 0 0 0 0 2 0 0 0 0 0 2 0 0 0 0 0 0 2 0 0 0 2 0 0 0 0 0 2 0 0 0 0 0 2 0 0 0 0 0 0 2 0 0 0 0 0 0
4 0 0 0 10 0 0 0 0 0 2 0 0 0 0 0 10 0 0 0 0 0 0 10 0 0 0 0 0 0 0 0 0 0 2 0 0 0 0 0 2 0 0 0 0 0 2 0 0 0
4 0 0 0 0 2 0 0 0 0 0 10 0 0 0 0 0 2 0 0 0 0 0 0 10 0 0 0 0 10 0 0 0 2 0 0 0 0 0 2 0 0 0 2 0 0 2 0 2 0
4 2 0 0 0 0 0 2 0 0 0 0 0 2 0 0 0 0 0 0 2 0 0 0 2 0 0 0 0 0 2 0 0 0 0 0 2 0 0 0 0 0 0 2 0 0 0 0 0 0
4 0 0 0 10 0 0 0 0 0 2 0 0 0 0 0 10 0 0 0 0 0 0 10 0 0 0 0 0 0 0 0 0 0 2 0 0 0 0 0 2 0 0 0 0 0 2 0 0 0
4 0 0 0 0 2 0 0 0 0 0 10 0 0 0 0 0 2 0 0 0 0 0 0 10 0 0 0 0 10 0 0 0 2 0 0 0 0 0 2 0 0 0 2 0 0 2 0 2 0
4 2 0 0 0 0 0 2 0 0 0 0 0 2 0 0 0 0 0 0 2 0 0 0 2 0 0 0 0 0 2 0 0 0 0 0 2 0 0 0 0 0 0 2 0 0 0 0 0 0
4 0 0 0 10 0 0 0 0 0 2 0 0 0 0 0 10 0 0 0 0 0 0 10 0 0 0 0 0 0 0 0 0 0 2 0 0 0 0 0 2 0 0 0 0 0 2 0 0 0
4 0 0 0 0 2 0 0 0 0 0 10 0 0 0 0 0 2 0 0 0 0 0 0 10 0 0 0 0 10 0 0 0 2 0 0 0 0 0 2 0 0 0 2 0 0 2 0 2 0
4 2 0 0 0 0 0 2 0 0 0 0 0 2 0 0 0 0 0 0 2 0 0 0 2 0 0 0 0 0 2 0 0 0 0 0 2 0 0 0 0 0 0 2 0 0 0 0 0 0
4 0 0 0 10 0 0 0 0 0 2 0 0 0 0 0 10 0 0 0 0 0 0 10 0 0 0 0 0 0 0 0 0 0 2 0 0 0 0 0 2 0 0 0 0 0 2 0 0 0
4 0 0 0 0 2 0 0 0 0 0 10 0 0 0 0 0 2 0 0 0 0 0 0 10 0 0 0 0 10 0 0 0 2 0 0 0 0 0 2 0 0 0 2 0 0 2 0 2 0
4 2 0 0 0 0 0 2 0 0 0 0 0 2 0 0 0 0 0 0 2 0 0 0 2 0 0 0 0 0 2 0 0 0 0 0 2 0 0 0 0 0 0 2 0 0 0 0 0 0
4 0 0 0 10 0 0 0 0 0 2 0 0 0 0 0 10 0 0 0 0 0 0 10 0 0 0 0 0 0 0 0 0 0 2 0 0 0 0 0 2 0 0 0 0 0 2 0 0 0
4 0 0 0 0 2 0 0 0 0 0 10 0 0 0 0 0 2 0 0 0 0 0 0 10 0 0 0 0 10 0 0 0 2 0 0 0 0 0 2 0 0 0 2 0 0 2 0 2 0
4 2 0 0 0 0 0 2 0 0 0 0 0 2 0 0 0 0 0 0 2 0 0 0 2 0 0 0 0 0 2 0 0 0 0 0 2 0 0 0 0 0 0 2 0 0 0 0 0 0
4 0 0 0 10 0 0 0 0 0 2 0 0 0 0 0 10 0 0 0 0 0 0 10 0 0 0 0 0 0 0 0 0 0 2 0 0 0 0 0 2 0 0 0 0 0 2 0 0 0


